#######~....~##
#~#...##.~#.##~
#...~.....#....
..#..#~~~.####.
.###.###.....#.
..@#...#.#*....
##.#.#...#.###.
#~.#.#.#.#####.
*....#.#.#####.
.###.#.#....#~.
.#~#######~....
.#.......~~.#~.
...#####....#..
.###...#.####.~
.....~...#$...~
